R  720
NO ./textures/brick.xpm
SO ./textures/blue.xpm
WE ./textures/wood.xpm
EA ./textures/grey.xpm

S ./textures/chalice.xpm
C 40,40,42
F 20,20,30

111
1011
1N021
1111
