R  720 720
NO ./textures/brick.xpm
SO ./textures/blue.xpm
WE ./textures/wood.xpm
EA ./textures/grey.xpm

S ./textures/chalice.xpm
F 224,172,105
C 205,249,255

111111111
1222E2221
111111111
